F 111,222,121
C 21,54,87

NO ./textures/texture_NO
SO ./textures/texture_SO
EA ./textures/texture_EA
WE ./textures/texture_WE




111111111111111111111111111111111
111111000000000000000000000111111
111100000000000000000000000001111
111000000000000000000000000000111
110000000000000000000000000000011
100001111111111111111111111100001
100001                     100001
10001                       10001
10001                       10001
10001                       10001
100001                     100001
100001111111111111111111111100001
110000000000000000000000000000011
111000000000000000000000000000111
111100000000000000000000000001111
111111000000000000000000000111111
111111111111111111111111111111111
