F 49, 102, 10
C 100, 250, 247


NO ./textures/texture_NO.xpm
SO ./textures/texture_SO.xpm
EA ./textures/texture_EA.xpm
WE ./textures/texture_WE.xpm
GU ./textures/pistoprout.xpm

111111111111111111111111111111111111111111111111111111111111111111
11111100000000000000000000000111111                              1
1111000000000000N000000000000001111                              1
11100000000000000000000000000000111         1                     1
11000000000111111011111100000000011                              11
10000000001100000000000110000000001         1                     1
10000000011000000000000011000000001         1                     1
10000000010000000000000001000000001         1                     1
100000000000000000000000000000000011111111111111111111111111111111                   1
10000000010000000000000001000000001                                                 101
10000000011000000000000011000000001                                                  1
10000000001100000000000110000000001
11000000000111111011111100000000011
11100000000000000000000000000000111
11110000000000000000000000000001111
11111100000000000000000000000111111
11111111111111111111111111111111111
