F 111,222,121
C 214,   47,  65


NO ./textures/texture_NO.xpm
SO ./textures/texture_SO.xpm
EA ./textures/texture_EA.xpm
WE ./textures/texture_WE.xpm
GU ./textures/pistoprout.xpm

11111111111111111111111111111111111
11111100000000000000000000000111111
1111000000000000E000000000000001111
11100000000000000000000000000000111
11000000000111111011111100000000011
10000000001100000000000110000000001
10000000011000000000000011000000001
10000000010000000000000001000000001
10000000000000000000000000000000001
10000000010000000000000001000000001
10000000011000000000000011000000001
10000000001100000000000110000000001
11000000000111111011111100000000011
11100000000000000000000000000000111
11110000000000000000000000000001111
11111100000000000000000000000111111
11111111111111111111111111111111111
