F 100, 100, 100
C 0, 0, 0


NO ./textures/texture_NO.xpm
SO ./textures/texture_SO.xpm
EA ./textures/texture_EA.xpm
WE ./textures/texture_WE.xpm
GU ./textures/pistoprout.xpm
1111111111111111111111111111111111111111111111
1111111111111111111111111110111111111111111111
1C11111111111111111111111111111111111111111111
1N00000000000000000000000000000000000000001111
1000000011111000000000001111100000000000000011
1000000011011000000000001101100000000000000011
1000000000000000000000000000000000000000000001
1000001110001110000000111000111100000111100001
1000011111011111000001111101111110000111100001
1000011111011111000001111101111110000001110001
1000011111011111000001111101111110000111100001
1000001110001110000000111000111100000111100001
1000000000000000000000000000000000000001100011
1000000000000000000000000000000000000001100011
1000001110001110000000111000111100000111100001
1000011111011111000001111101111110000111100001
1000011111011111000001111101111110000001110001
1000011111011111000001111101111110000111100001
1000001110001110000000111000111100000111100001
1000000000000000000000000000000000000000000001
1000000011011000000000001101100000000000000011
1000000011111000000000001111100000000000000111
1000000000000000000000000000000000000000001111
1111111111111111111111111111111111111111111111
