11111111111
10100100101
10010010011
10000110001
10010000111
11111111111
